other or upper gi therapeutic procedures	are performed for	treatment
endoscopy	is a type of	other or upper gi therapeutic procedures
colonoscopy	is a type of	other or upper gi therapeutic procedures
gastrointestinal bleeding	can be treated with	other or upper gi therapeutic procedures
polyp removal	is a common treatment in	other or upper gi therapeutic procedures
foreign body removal	is a possible treatment in	other or upper gi therapeutic procedures
hemostasis	is performed during	other or upper gi therapeutic procedures
endoscopic dilatation	is a type of	other or upper gi therapeutic procedures
other or upper gi therapeutic procedures	can be used to diagnose	gastrointestinal conditions
cancer	can be detected during	other or upper gi therapeutic procedures
gastroesophageal reflux	can be diagnosed and treated with	other or upper gi therapeutic procedures
complications	can occur due to	other or upper gi therapeutic procedures
patient satisfaction	is important in	other or upper gi therapeutic procedures
recovery time	varies after	other or upper gi therapeutic procedures
patient preparation	is necessary before	other or upper gi therapeutic procedures
comfort measures	are utilized during	other or upper gi therapeutic procedures
endoscopy center	is where	other or upper gi therapeutic procedures are performed
anesthesia	may be used during	other or upper gi therapeutic procedures
scopes and instruments	are necessary for	other or upper gi therapeutic procedures
patient monitoring	is done during	other or upper gi therapeutic procedures
training and expertise	are required for	other or upper gi therapeutic procedures
surgical intervention	may be recommended after	other or upper gi therapeutic procedures
complications	can be minimized with	other or upper gi therapeutic procedures
patient discomfort	can be reduced during	other or upper gi therapeutic procedures
barium swallow	is a type of	other or upper gi therapeutic procedures
esophagogastroduodenoscopy	is a type of	other or upper gi therapeutic procedures
endoscopic ultrasound	is a type of	other or upper gi therapeutic procedures
endoscopic retrograde cholangiopancreatography	is a type of	other or upper gi therapeutic procedures
photodynamic therapy	can be performed during	other or upper gi therapeutic procedures
laser therapy	can be performed during	other or upper gi therapeutic procedures
other or upper gi therapeutic procedures	are typically outpatient
complications	can necessitate hospitalization after	other or upper gi therapeutic procedures
follow-up care	is important after	other or upper gi therapeutic procedures
patient education	is provided before	other or upper gi therapeutic procedures
gastroenterologist	specializes in	other or upper gi therapeutic procedures
referred pain	can be experienced after	other or upper gi therapeutic procedures
post-procedure instructions	are given to patients following	other or upper gi therapeutic procedures
infection	can be a risk after	other or upper gi therapeutic procedures
bleeding	can occur after	other or upper gi therapeutic procedures
scarring	can result from	other or upper gi therapeutic procedures
sedation	may be used during	other or upper gi therapeutic procedures
upper gastrointestinal series	is a type of	other or upper gi therapeutic procedures
patient compliance	is crucial for successful outcomes in	other or upper gi therapeutic procedures
biopsy	may be performed during	other or upper gi therapeutic procedures
pathology report	is obtained after	other or upper gi therapeutic procedures
esophageal stent placement	is a possible treatment in	other or upper gi therapeutic procedures
stent migration	can occur after	other or upper gi therapeutic procedures
rigid endoscopy	is a type of	other or upper gi therapeutic procedures
retroflexion	is a technique used in	other or upper gi therapeutic procedures
esophageal varices	can be treated with	other or upper gi therapeutic procedures
endoscopic mucosal resection	is a type of	other or upper gi therapeutic procedures
endoscopic submucosal dissection	is a type of	other or upper gi therapeutic procedures
ultrasound-guided procedures	can be used during	other or upper gi therapeutic procedures
gastric bypass	is a type of	other or upper gi therapeutic procedures
obesity	can be treated with	other or upper gi therapeutic procedures
esophageal cancer	can be diagnosed and treated with	other or upper gi therapeutic procedures
barrett's esophagus	can be diagnosed and monitored with	other or upper gi therapeutic procedures
