coagulation and hemorrhagic disorders	are related to	bleeding
bleeding	can lead to	anemia
anemia	may cause	fatigue
fatigue	can affect	daily activities
daily activities	may be limited by	fatigue
fatigue	can be managed with	rest
rest	is important for	recovery
recovery	may be slower in	older adults
older adults	are more prone to	coagulation and hemorrhagic disorders
coagulation and hemorrhagic disorders	can be diagnosed with	blood tests
blood tests	can detect	clotting abnormalities
clotting abnormalities	can be caused by	genetic factors
genetic factors	may contribute to	coagulation and hemorrhagic disorders
coagulation and hemorrhagic disorders	can be treated with	medication
medication	can help manage	clotting problems
clotting problems	can be life-threatening
life-threatening	situations require	immediate medical attention
immediate medical attention	is necessary to prevent	complications
complications	can arise from	coagulation and hemorrhagic disorders
coagulation and hemorrhagic disorders	have a higher risk of	mortality
mortality	rates are higher in	severe cases
severe cases	require	specialized care
specialized care	may be provided by	hematologists
hematologists	are doctors specializing in	blood disorders
blood disorders	include	coagulation and hemorrhagic disorders
coagulation and hemorrhagic disorders	have	multiple causes
multiple causes	can include	liver disease
liver disease	affects	blood clotting
blood clotting	is necessary for	wound healing
wound healing	is impaired in	coagulation and hemorrhagic disorders
coagulation and hemorrhagic disorders	can result in	excessive bleeding
excessive bleeding	can lead to	hemorrhage
hemorrhage	is a	medical emergency
medical emergency	requires	immediate intervention
immediate intervention	is crucial to	prevent complications
complications	can include	organ damage
organ damage	can be permanent
permanent	organ damage may lead to	disability
disability	can affect	quality of life
quality of life	can be improved with	appropriate treatment
appropriate treatment	involves	managing bleeding episodes
managing bleeding episodes	includes	blood transfusions
blood transfusions	can restore	normal clotting function
normal clotting function	is essential for	hemostasis
hemostasis	is the	process of blood clotting
process of blood clotting	involves	platelets
platelets	are responsible for	clot formation
clot formation	prevents	excessive bleeding
excessive bleeding	can lead to	hemorrhagic shock
hemorrhagic shock	is a	life-threatening condition
life-threatening condition	requires	immediate medical intervention
immediate medical intervention	aims to	stabilize the patient
stabilize the patient	involves	resuscitation measures
resuscitation measures	include	fluid replacement
fluid replacement	is necessary to	maintain blood volume
maintain blood volume	ensures	adequate oxygen delivery
adequate oxygen delivery	is crucial for	organ function
organ function	can be compromised in	hemorrhagic disorders
hemorrhagic disorders	are associated with	prolonged bleeding
prolonged bleeding	can lead to	anemia
anemia	may require	iron supplementation
iron supplementation	helps	restore hemoglobin levels
hemoglobin levels	are important for	oxygen transport
oxygen transport	is vital for	cellular function
cellular function	can be impaired in	hemorrhagic disorders
hemorrhagic disorders	are characterized by	abnormal clotting
abnormal clotting	can result in	thrombosis
thrombosis	is the	formation of blood clots
formation of blood clots	can block	blood vessels
blood vessels	are essential for	circulation
circulation	plays a crucial role in	delivering nutrients and oxygen
delivering nutrients and oxygen	is necessary for	tissue function
tissue function	can be compromised in	coagulation and hemorrhagic disorders
coagulation and hemorrhagic disorders	can be managed with	anticoagulant therapy
anticoagulant therapy	helps	prevent blood clot formation
blood clot formation	can cause	blockages
blockages	can lead to	ischemic events
ischemic events	require	immediate intervention
immediate intervention	aims to	restore blood flow
restore blood flow	helps	prevent tissue damage
tissue damage	can result in	organ dysfunction
organ dysfunction	is a	risk factor for mortality
mortality	rates are higher in	patients with organ dysfunction
patients with organ dysfunction	require	intensive care
intensive care	is necessary for	close monitoring
close monitoring	helps	detect complications
detect complications	allows for	prompt intervention
prompt intervention	can improve	patient outcomes
patient outcomes	are influenced by	early diagnosis
early diagnosis	facilitates	timely treatment
timely treatment	is crucial for	preventing complications
preventing complications	can reduce	mortality rates
mortality rates	are lower in	patients with timely treatment
patients with timely treatment	experience improved	quality of life
quality of life	is affected by	disease severity
disease severity	can vary in	coagulation and hemorrhagic disorders
coagulation and hemorrhagic disorders	can be managed with	lifestyle modifications
lifestyle modifications	include	regular exercise
regular exercise	can improve	cardiovascular health
cardiovascular health	is important for	optimal blood clotting
optimal blood clotting	is necessary to	prevent excessive bleeding
preventing excessive bleeding	can reduce	complications
complications	can negatively impact	prognosis
prognosis	is influenced by	disease progression
disease progression	can be monitored with	regular medical check-ups
regular medical check-ups	allow for	treatment adjustments
treatment adjustments	can optimize	disease management
disease management	aims to	improve symptoms
improve symptoms	enhance	patient comfort
patient comfort	contributes to	overall well-being
overall well-being	is important for	quality of life
quality of life	can be affected by	coagulation and hemorrhagic disorders
coagulation and hemorrhagic disorders	require	long-term management
long-term management	involves	regular follow-up care
regular follow-up care	helps	prevent disease progression
disease progression	can lead to	complications
complications	require	timely intervention
timely intervention	is crucial for	improving patient outcomes
improving patient outcomes	is the goal of	medical management
medical management	focuses on	symptom control
symptom control	can improve	quality of life
quality of life	is influenced by	disease severity
disease severity	can be assessed with	laboratory tests
laboratory tests	provide	objective data
objective data	is important for	treatment decisions
treatment decisions	should be based on	evidence-based guidelines
evidence-based guidelines	help	guide medical practice
guide medical practice	ensures	optimal patient care
optimal patient care	is the aim of	healthcare professionals
healthcare professionals	play a crucial role in	managing coagulation and hemorrhagic disorders
managing coagulation and hemorrhagic disorders	requires	a multidisciplinary approach
a multidisciplinary approach	involves	collaboration between different specialties
collaboration between different specialties	can improve	patient outcomes
